********#********
o##*###*#*###*##o
*##*###*#*###*##*
*****************
*##*#*#####*#*##*
****#***#***#****
###*###O#O###*###
###*#OOOOOOO#*###
###*#O#####O#*###
OOO*OO#GGG#OO*OOO
###*#O#####O#*###
###*#OOOOOOO#*###
###*#O#####O#*###
********#********
*##*###*#*###*##*
o*#*****@*****#*o
#*#*#*#####*#*#*#
****#***#***#****
*######*#*######*
*****************

